{
0;0;0;0;0;0;0;0;0;0
0;0;0;0;0;0;0;0;0;0
0;0;0;0;0;0;0;0;0;0
0;0;0;0;0;0;0;0;0;0
0;0;2;0;32;0;1;0;0;0
0;0;0;0;0;0;0;0;0;0
0;0;0;0;0;0;0;0;0;0
0;0;0;0;0;4;0;0;0;0
0;0;0;0;0;0;0;0;0;0
0;0;0;0;0;0;0;0;0;0
}
{
0;0;0;0;0;0;0;0;0;0
0;33;1;1;1;1;3;2;0;0
0;0;0;0;0;0;0;0;0;0
0;0;0;0;0;0;0;0;0;0
0;0;0;0;0;0;0;0;0;0
0;0;0;0;0;0;0;0;0;0
0;0;0;0;0;0;0;0;0;0
0;0;0;0;0;0;0;0;0;0
0;0;0;0;0;0;0;0;0;0
0;4;0;0;0;0;0;0;0;0
}
{
2;0;0;0;0;0;0;0;0;0
0;0;0;0;0;0;0;0;0;0
0;0;0;0;0;0;0;0;0;0
0;0;0;0;0;0;0;0;0;0
0;0;0;0;0;0;0;4;0;0
0;0;0;0;0;0;0;0;0;0
0;0;0;0;0;0;0;0;0;0
0;0;0;0;0;0;0;0;0;0
0;0;0;32;0;0;0;31;1;0
1;1;1;1;1;1;1;1;1;1
}
{
0;0;0;0;0;0;0;0;0;0
0;1;1;1;1;1;1;1;1;0
0;1;0;1;0;0;0;0;1;0
0;1;0;0;0;3;1;3;1;0
0;0;0;31;1;2;0;0;0;0
0;1;0;0;0;30;0;1;1;0
0;1;0;0;0;0;0;0;1;0
0;1;0;1;1;4;0;1;1;0
0;1;1;1;1;1;1;1;1;0
0;0;0;0;0;0;0;0;0;0
}
{
32;1;0;0;0;1;0;0;0;2
0;0;0;0;30;0;0;0;0;0
0;0;0;0;0;0;0;1;0;0
0;0;0;0;0;0;0;3;1;0
0;0;0;0;1;0;0;0;0;0
1;0;0;0;0;0;0;0;0;0
33;0;0;0;4;0;0;0;1;3
0;0;1;0;0;0;0;0;0;1
0;0;0;1;0;0;0;0;0;0
0;0;0;0;0;0;1;0;0;0
}
{
0;0;0;0;0;0;0;1;0;0
0;0;0;1;0;0;0;0;0;0
0;0;0;0;0;0;0;0;1;0
0;3;1;3;0;0;0;3;0;0
0;0;0;0;0;0;32;1;30;0
1;4;0;0;0;0;0;30;0;0
0;0;0;0;0;0;0;0;0;0
0;0;0;0;3;0;0;0;0;0
0;1;0;0;1;0;0;2;0;0
0;0;0;0;0;0;0;1;0;0
}
{
0;1;0;1;0;1;0;1;0;0
1;3;0;0;1;0;0;0;0;0
0;0;0;0;1;0;0;0;0;0
0;0;1;0;3;0;1;0;0;0
0;1;0;0;0;0;0;0;0;0
1;33;32;33;2;33;32;33;32;1
0;0;0;0;1;1;0;0;0;0
0;0;0;0;0;0;0;4;0;0
0;0;0;1;0;0;0;0;0;0
0;1;0;0;0;0;0;1;0;0
}
{
0;0;1;1;1;1;1;1;0;0
0;0;0;31;31;31;31;31;31;1
0;1;3;0;1;1;1;1;30;0
1;3;3;1;3;3;3;3;1;0
1;3;1;1;3;1;1;3;1;0
1;3;3;1;3;3;1;3;1;0
1;3;3;1;2;3;1;3;1;0
0;1;3;1;1;1;1;3;1;0
4;1;3;3;3;3;3;3;1;0
0;0;1;1;1;1;1;1;0;0
}
{
0;0;0;0;0;0;1;0;0;0
0;0;1;0;0;0;0;1;0;0
1;0;3;0;0;3;0;1;4;0
0;0;0;0;0;1;0;0;0;0
0;1;31;0;0;33;0;0;0;0
0;0;0;0;0;0;0;0;0;0
0;0;0;0;0;0;0;0;0;0
0;0;0;0;0;0;0;0;0;0
0;0;0;0;0;30;0;1;0;0
2;0;0;32;1;0;1;0;0;0
}